name
0001_1024
0002_1024
0003_1024
0004_1024
0005_1024
0006_1024
0007_1024
0008_1024
0009_1024
0010_1024